9 9 9 9 9 9 9 9 9 9 9 9 9 9 9 9 9 9 9 9 9 9 9 9 9 9 9 9 9 9 9 9
9 2 2 2 2 2 2 2 2 2 2 2 2 2 2 2 3 3 2 2 2 3 3 3 3 3 3 3 3 2 2 9
9 2 2 2 2 3 3 3 3 3 3 3 2 2 2 2 3 3 2 2 2 3 3 3 3 3 3 3 3 2 2 9
9 2 2 2 2 3 3 3 3 3 3 3 2 2 2 2 3 3 3 3 3 3 3 2 2 2 2 3 3 3 3 9
9 2 2 2 2 2 2 2 2 2 3 3 2 2 2 2 3 3 3 3 3 3 3 2 2 2 2 3 3 3 3 9
9 2 2 2 2 2 2 2 2 5 3 3 5 2 2 6 3 3 2 2 2 3 3 2 2 2 2 3 3 2 2 9
9 2 2 2 3 3 3 3 3 3 3 3 3 3 3 3 3 3 2 2 2 3 3 3 3 3 3 3 3 2 2 9
9 2 2 2 3 3 3 3 3 3 3 3 3 3 3 3 3 3 6 2 2 3 3 3 4 3 3 3 3 2 2 9
9 2 2 2 2 3 2 2 2 2 3 3 5 2 2 7 3 4 2 2 2 2 2 2 2 2 2 2 2 2 2 9
9 2 2 2 2 3 2 2 2 2 3 3 2 2 2 2 3 3 2 2 2 2 2 2 2 2 2 2 2 2 2 9
9 2 2 2 2 3 2 2 2 2 3 3 2 2 2 2 3 3 2 2 2 2 2 2 2 2 2 2 2 2 2 9
9 2 2 2 2 3 2 2 2 9 3 3 2 2 2 2 3 3 2 2 2 2 2 2 2 2 2 2 2 2 2 9
9 2 2 2 2 3 3 3 3 3 3 3 2 2 2 2 3 3 2 2 2 2 2 2 2 2 2 2 2 2 2 9
9 2 2 2 2 2 2 2 2 9 2 2 2 2 2 2 3 3 3 3 2 2 2 2 2 2 2 2 2 2 2 9
9 2 2 2 2 2 2 2 2 2 2 2 2 2 2 2 3 3 3 3 2 2 2 2 2 2 2 2 2 2 2 9
9 2 2 2 2 2 2 2 2 2 2 2 2 2 2 2 2 2 3 3 2 2 2 2 2 2 2 2 2 2 2 9
9 2 2 2 2 2 2 2 2 2 2 2 2 2 2 2 2 2 3 3 2 2 2 2 2 2 2 2 2 2 2 9
9 2 2 2 2 2 2 2 2 2 2 2 2 2 2 2 2 2 3 3 2 2 2 2 2 2 2 2 2 2 2 9
9 2 2 2 2 2 2 2 2 2 2 2 2 2 2 2 2 2 3 3 2 2 2 2 2 2 2 2 2 2 2 9
9 2 2 2 2 2 2 2 2 2 2 2 2 2 2 2 2 2 3 3 2 2 2 2 2 2 2 2 2 2 2 9
9 9 9 9 9 9 9 9 9 9 9 9 9 9 9 9 9 9 9 9 9 9 9 9 9 9 9 9 9 9 9 9
